111111111100
111111111111
111111111111
111111111111
111111111100
000011111100