00000000000
01111111110
01111111110
01111001100
01111011110
01111011110
00000000000