111111110111111011000
111111111111111011111
111111110111111000111
111111110111111011111
000110000001100011111
111111101111111111111
111111101111111111111
111111111111111011111
111111111111111001000
111111101111111011110
111111101111111011110